[level]
#   000000000000000000000000000000000000000000000000000000000000 = Full


map=0000000000000000000000000000000
    0#############################0
    0000##########################0
    0#############00000###########0
    0########0####################0
    0#########################00000
    0#############################0
    0#############################0
    0############0######0#########0
    0####00#############00########0
    0###################0#########0
    0###################0#########0
    0000000000000000000000000000000
